B,B,B,B,B,B,B,B,B,B,B,B,B,B,B,B,B,B,B,B,B,B,B,B,B,B,B,B,B,B,B,B,B,B,B,B,B,B,B,B,B,B,B,B,B,B,B,B,B,B,B,B,B,B,B,B,B,B,B,B,B,B,B,B
B,E,E,E,E,E,E,E,E,E,E,E,E,E,E,E,E,E,E,E,E,E,E,E,E,E,E,E,E,E,E,E,E,E,E,E,E,E,E,E,E,E,E,E,E,E,E,E,E,E,E,E,E,E,E,E,E,E,E,E,E,E,E,B
B,E,E,E,E,E,E,E,E,E,E,E,E,E,E,E,E,E,E,E,E,E,E,E,E,E,E,E,E,E,E,E,E,E,E,E,E,E,E,E,E,E,E,E,E,E,E,E,E,E,E,E,E,E,E,E,E,E,E,E,E,E,E,B
B,E,E,E,E,E,E,E,E,E,E,E,E,E,E,E,E,E,E,E,E,E,E,E,E,E,E,E,E,E,E,E,E,E,E,E,E,E,E,E,E,E,E,E,E,E,E,E,E,E,E,E,E,E,E,E,E,E,E,E,E,E,E,B
B,E,E,E,E,E,E,E,E,E,E,E,E,E,E,E,E,E,E,E,E,E,E,E,E,E,E,E,E,E,E,E,E,E,E,E,E,E,E,E,E,E,E,E,E,E,E,E,E,E,E,E,E,E,E,E,E,E,E,E,E,E,E,B
B,E,E,E,E,E,E,E,E,E,E,E,E,E,E,E,E,E,E,E,E,E,E,E,E,E,E,E,E,E,E,E,E,E,E,E,E,E,E,E,E,E,E,E,E,E,E,E,E,E,E,E,E,E,E,E,E,E,E,E,E,E,E,B
B,E,E,E,E,E,E,E,E,E,E,E,E,E,E,E,E,E,E,E,E,E,E,E,E,E,E,E,E,E,E,E,E,E,E,E,E,E,E,E,E,E,E,E,E,E,E,E,E,E,E,E,E,E,E,E,E,E,E,E,E,E,E,B
B,E,E,E,E,E,E,E,E,E,E,E,E,E,E,E,E,E,E,E,E,E,E,E,E,E,E,E,E,E,E,E,E,E,E,E,E,E,E,E,E,E,E,E,E,E,E,E,E,E,E,E,E,E,E,E,E,E,E,E,E,E,E,B
B,E,E,E,E,E,E,E,E,E,J,=,L,E,E,E,E,E,E,E,E,E,E,E,E,E,E,E,E,E,E,E,E,E,E,E,E,E,E,E,E,E,E,E,E,E,E,E,E,E,E,E,E,E,E,E,E,E,E,E,E,E,E,B
B,E,E,E,E,E,E,E,E,{,&,&,&,},E,E,E,E,E,E,E,E,E,E,E,E,E,E,E,E,E,E,E,E,E,E,E,E,E,E,E,E,E,E,E,E,E,E,E,E,E,E,E,E,E,E,E,E,E,E,E,E,E,B
B,E,E,E,E,E,E,E,E,E,N,N,N,E,E,E,E,E,E,E,E,E,E,E,E,E,E,E,E,E,E,E,E,E,E,E,E,E,E,E,E,E,E,E,E,E,E,E,E,E,E,E,E,E,E,E,E,E,E,E,E,E,E,B
B,E,E,E,E,E,E,E,E,E,E,E,E,E,E,E,E,E,E,E,E,E,E,E,E,E,J,=,L,E,E,E,E,E,E,E,E,E,E,E,E,E,E,E,E,E,E,E,E,E,E,E,E,E,E,E,E,E,E,E,E,E,E,B
B,E,E,E,E,E,E,E,E,E,E,E,E,E,E,E,E,E,E,E,E,E,E,E,E,{,&,&,&,},E,E,E,E,E,E,E,E,E,E,E,E,E,E,E,E,E,E,E,E,E,E,E,E,E,E,E,E,E,E,E,E,E,B
B,E,E,E,E,E,E,E,E,E,E,E,E,E,E,E,E,E,E,E,E,E,E,E,E,E,N,N,N,E,E,E,E,E,E,E,E,E,E,E,E,E,E,E,E,E,E,E,E,E,E,E,E,E,E,E,E,E,E,E,E,E,E,B
B,E,E,E,E,E,E,E,E,E,E,E,E,E,E,E,E,E,E,E,E,E,E,E,E,E,E,E,E,E,E,E,E,E,E,E,E,E,E,E,E,E,E,E,E,E,E,E,E,E,E,E,E,E,E,E,E,E,E,E,E,E,E,B
B,E,E,E,E,E,E,E,E,E,E,E,E,E,E,E,E,E,E,E,E,E,E,E,E,E,E,E,E,E,E,E,E,E,E,E,E,E,E,E,E,E,E,E,E,E,E,E,E,E,E,E,E,E,E,E,E,E,E,E,E,E,E,B
B,E,E,E,E,E,E,E,E,E,E,E,E,E,E,E,E,E,E,E,E,E,E,E,E,E,E,E,E,E,E,E,E,E,E,E,E,E,E,E,E,E,E,E,E,E,E,E,E,E,E,E,E,E,E,E,E,E,E,E,E,E,E,B
B,E,E,E,E,E,E,E,E,E,E,E,E,E,E,E,E,E,E,E,E,E,E,E,E,E,E,E,E,E,E,E,E,E,E,E,E,E,E,E,E,E,E,E,E,E,E,E,E,E,E,E,E,E,E,E,E,E,E,E,E,E,E,B
B,E,E,E,E,E,E,E,E,E,E,E,E,E,E,E,E,E,E,E,E,E,E,E,E,E,E,E,E,E,E,E,E,E,E,E,E,E,E,E,E,E,E,E,E,E,E,E,E,E,E,E,E,E,E,E,E,E,E,E,E,E,(,B
B,E,E,E,E,E,E,E,E,E,E,E,E,E,E,E,E,E,E,E,E,E,E,E,E,E,E,E,E,E,E,E,E,E,E,E,E,E,E,E,E,E,E,E,E,E,E,E,E,E,E,E,E,E,E,E,E,E,E,E,E,E,O,B
B,E,E,E,E,E,E,E,E,E,E,E,E,E,E,E,E,E,E,E,E,E,E,E,E,E,E,E,E,E,E,E,E,E,E,E,E,E,E,E,E,E,E,E,E,E,E,E,E,E,E,E,E,E,E,E,E,E,E,E,E,E,O,B
B,E,E,E,E,E,E,E,E,E,E,E,E,E,E,E,E,E,E,E,E,E,E,E,E,E,E,E,E,E,E,E,E,E,E,E,E,E,E,E,E,E,E,E,E,E,E,E,E,E,E,E,E,E,E,E,E,E,E,E,E,E,O,B
B,E,E,E,E,E,E,E,E,E,E,E,E,E,E,E,E,E,E,E,E,E,E,E,E,E,E,E,E,E,E,E,E,E,E,E,E,E,E,E,E,E,E,E,E,E,E,E,E,E,E,E,E,E,E,E,E,E,E,E,E,E,O,B
B,E,E,E,E,E,E,E,E,E,E,E,E,E,E,E,E,E,E,E,E,E,E,E,E,E,E,E,E,E,E,E,E,E,E,E,E,E,E,E,E,E,E,E,d,E,E,E,E,E,E,E,E,E,E,E,E,E,E,E,E,E,O,B
B,E,E,E,E,E,E,E,E,E,E,E,E,E,E,E,E,E,E,E,E,E,E,E,E,E,E,E,E,E,O,E,E,d,E,E,E,E,E,E,|,-,-,-,-,-,|,-,-,-,-,-,|,E,E,E,E,E,E,E,E,-,-,B
B,E,E,E,E,E,E,E,E,E,E,E,E,E,E,E,E,E,E,E,E,E,E,E,E,E,E,E,E,O,O,-,-,-,-,-,-,-,-,-,-,|,-,O,-,-,|,-,-,-,-,|,-,_,E,E,E,E,E,E,E,-,|,B
B,E,E,E,E,E,E,E,E,E,E,E,(,A,),E,E,E,E,E,E,E,E,E,E,E,E,E,O,O,O,-,_,-,-,-,-,-,-,-,-,-,-,O,-,-,|,-,-,-,-,-,-,_,E,E,E,E,E,E,E,E,|,B
B,E,E,E,E,E,E,E,E,E,E,(,<,A,>,),E,E,E,E,E,E,E,E,E,E,E,E,O,O,O,-,-,-,-,-,-,-,-,-,-,-,O,O,-,-,|,-,-,-,_,_,_,E,E,E,E,E,E,E,E,E,|,B
B,E,J,=,L,E,E,E,E,E,E,<,O,O,O,>,E,E,E,E,E,E,E,E,E,E,E,E,-,O,O,-,_,_,_,-,-,-,-,-,-,O,O,O,-,-,|,-,-,-,E,E,E,E,E,E,E,E,E,E,|,O,-,B
B,{,&,&,&,},E,E,E,E,E,(,<,O,>,),E,E,E,E,E,E,E,E,E,E,E,_,-,O,O,-,-,-,-,-,-,-,-,-,O,O,O,O,-,-,|,-,-,E,E,E,E,E,E,E,E,E,E,|,-,O,O,B
B,E,e,e,e,E,E,E,E,E,E,<,O,O,O,>,E,E,E,E,E,E,E,E,-,_,_,-,O,O,O,-,-,-,-,-,-,-,-,-,O,O,O,O,-,-,|,-,-,E,E,E,E,E,E,E,E,E,E,|,-,O,O,B
B,E,E,E,E,E,E,E,E,E,E,(,<,O,>,),E,E,E,E,E,E,E,-,_,_,O,O,O,O,O,-,-,-,-,-,-,-,-,-,O,O,O,O,-,-,-,-,0,1,E,E,E,E,E,E,E,E,E,|,-,O,O,B
B,E,E,E,E,E,E,E,E,E,E,<,O,O,O,>,E,E,E,E,E,E,E,-,O,O,O,O,O,O,O,-,-,|,-,-,-,-,-,-,-,O,O,-,-,-,-,0,0,1,E,E,E,E,E,E,E,E,E,|,-,O,O,B
B,E,E,E,E,E,E,E,E,E,E,E,E,T,E,E,E,E,E,E,E,E,O,O,O,_,_,_,O,O,O,-,-,|,-,-,-,-,-,-,O,O,-,O,-,-,-,0,0,1,E,E,7,E,E,E,E,E,E,|,O,O,O,B
B,¤,¤,¤,¤,¤,¤,¤,¤,¤,¤,¤,¤,¤,¤,¤,¤,w,w,w,w,w,¤,¤,¤,¤,¤,¤,¤,¤,¤,¤,¤,¤,¤,¤,¤,¤,¤,¤,¤,¤,¤,¤,¤,¤,¤,¤,¤,¤,¤,¤,¤,¤,¤,¤,¤,¤,¤,¤,¤,¤,¤,B
B,B,B,B,B,B,B,B,B,B,B,B,B,B,B,B,B,B,B,B,B,B,B,B,B,B,B,B,B,B,B,B,B,B,B,B,B,B,B,B,B,B,B,B,B,B,B,B,B,B,B,B,B,B,B,B,B,B,B,B,B,B,B,B